
F 84,217,225
C 93,220,121


NO ./ice.xpm
SO ./ice.xpm
WE ./ice.xpm
EA ./ice.xpm


1111111111
10000001101     11111
100S000000111  1 1 101
100001000101       111
100000111111     111
10100011       111
1111111       111