
F 84,217,225
C 93,220,121


NO ./42_textura.xpm
SO ./42_textura2.xpm
WE ./42_textura3.xpm
EA ./42_textura4.xpm


1111111111
10000001101     11111
100S000000111  1 1 101
100001000101       111
100000111111     111
10100011       111
1111111       111