
F 4,100,8
C 22,30,240


NO ./ice.xpm
SO ./ice.xpm
WE ./ice.xpm
EA ./ice.xpm


111111111
1000011 1     111
110N0111  1 1 101
1 111 1       111