
F 255,255,0
C 255,0,0


NO ./ice.xpm
SO ./ice.xpm
WE ./ice.xpm
EA ./ice.xpm


1111111111
10000001101     11111
100S000100011  1 1 101
100001000101       111
100000111111     111
100100011       111
1111111       111