
F 255,255,0
C 255,0,0


NO ./ice.xpm
SO ./ice.xpm
WE ./ice.xpm
EA ./ice.xpm


111111111
100000011 1     111
100S000111  1 1 101
100001011       111
100000111       111
100100011       111
1111111       111