
F 4,100,8
C 22,30,240


NO ./ice.xpm
SO ./ice.xpm
WE ./ice.xpm
EA ./ice.xpm


111111111
101000011 1     111
100S000111  1 1 101
100001011       111
100000111       111
100100011       111
1111111       111