
F 84,217,225
C 93,220,121


NO ./jokin.xpm
SO ./jokin2.xpm
WE ./jokin3.xpm
EA ./jokin4.xpm


1111111111
10000001101     11111
100N000000111  1 1 101
100001000101       111
100000111111     111
10100011       111
1111111       111