
F 84,217,225
C 93,220,121


NO ./42_textura_pared.xpm
SO ./42_textura_pared.xpm
WE ./42_textura_pared.xpm
EA ./42_textura_pared.xpm

1111111110011
1111111110011
1000000000111
1000000000111
1000000000111
100000000N111
1010000000111
1111111111111