F 255,255,0
C 255,0,0


NO ./ice.xpm
SO ./ice.xpm
WE ./ice.xpm
EA ./ice.xpm


111111111
100000001
100000001
1000N0001
11111111
